Woah.

You're dead. You have to be.

Fifty-one hours and an eyeblink ago you stood in front of a crowd of fifty-thousand outside the Gas Temple and made it clear that nobody was going to break you, your company, your shareholders, or the spirit of a people.

A minute later, you were assassinated.

At least, that's how it was supposed to go. You're supposed to be dead. Buried under a mountain of gray California dirt. So why does it feel like you're still alive?

Industry
An Interactive Fiction by Charles Cox
Release 1 / Serial number 110508 / Inform 7 build 6G60 (I6/v6.32 lib 6/12N) SD

Forty-Fourth Floor Staircase
You are against the wall of a concrete staircase, cold and pourous. Through red emergency lighting, you can see a large stenciled number on the wall, indicating the forty-fourth floor. Somewhere, drifting in the echo of the concrete, you can hear the muffled sounds of fireworks, celebrating Armistice Day.

The stairs that lead up terminate at a concrete support, in which an entryway is just barely visible. Downward, the staircase leads into a dark black fog.

A handrail twists down the near edge of the staircase.

There is a fire locker on the wall.

>xyzzy
Departure Lounge
People surround you; hurried, frayed, fast. Glass and steel beamwork cross in sweeping orbits around a large curved window that looks out over a greenbelted cityscape. The smell of hastily-fried foods mixed with heavy coffees. Black leather chairs embossed with friendly ORBGROUP logos line the main thoroughfare; white tile floors cut by vanishing-point aluminum slices extend on to the west and east until they curve out of sight. To your south is Gate Six.

There is a suited man here, busy on his phone.

-- (LOG) $82 $2 -- (CIA) $89 $9 -- (YOU) $49 $-1 -- 
Symbol ----- Name ------ Price | +/-
LOG | LogoS Corporation | $82  | $2
CIA | Clayton Info.Acq. | $89  | $9
YOU | You, Incorporated | $49  | $-1

>xyzzy
Restroom
You look around the tiny restroom. It was made for the comfort of one person; the room is set out in dark marbles with Chinoise accent. The motion detector has already triggered a dim recessed panel of lighting, and you can see the basics of the room in fuzzy relief around you.

You see your reflection in the mirror.

You can also see a sink and a toilet here.

-- (LOG) $82 $0 -- (CIA) $89 $0 -- (YOU) $49 $0 -- 
Symbol ----- Name ------ Price | +/-
LOG | LogoS Corporation | $82  | $0
CIA | Clayton Info.Acq. | $89  | $0
YOU | You, Incorporated | $49  | $0

>e
You unlock the door and head back out to the food court.

Food Court
Things seem quiet in the food court now - maybe everyone has boarded for Gate Six.

The man drinking coffee has moved to another table.

>s
You hear a click from behind you.
"Don't move", a voice says from the food court. "United States Treasury Department."
You freeze up - not sure if you should run or stay.
"That's good", the voice says behind you, finally coming around to face you. It is the man from the food court, now brandishing a compact pistol, and wearing a badge and earpiece. "We know you, but you don't know me. I'm Joseph Weaver, Financial Crimes Division." Weaver looks you in the eyes, but you find it hard not to stare at the little black pistol he points right at you.

Before he can say any more, an alarm sounds throughout the concourse.

"What the hell -" Weaver starts, but is interrupted by gunshots down the concourse to the east - followed closely behind by screams as travelers in the departure lounge panic at the shots.

You break from him and run south to the departure lounge!

You can see Weaver catching up with you! You had better get out of here.

Departure Lounge West
The recent gunfire has transformed the departure lounge into a river of panic - travelers are diving for cover, rapidly yelling to emergency services on mobile phones, or trying to find ways out of the terminal without exposing themselves to further harm. The scene is chaos - every traveler is out for themselves.You can see the rest of the departure lounge concourse to the east, and Gate Five is to the south.

(type SURRENDER to give up)

>e
You bolt down the departure concourse, headed east!

"Over here!" shouts a voice from down the concourse. "Did you get my note?"
"Where are you?" you shout, taking cover behind a planter.
"Right here", the voice says, the speaker appearing behind a very frightened-looking ORBGROUP gate agent. You notice the agent has a gun to their head, and the mysterious stranger is holding it, keeping the agent in a body-shield grip in front of him.
"What the hell -" you start to ask, but duck back down as Weaver approaches.
"Trying to survive," the man says. "Now it's your turn. Grab that man in the suit in the corner and let's go. Catch." He tosses something in the air - it slides on the tile toward you, stopping at your feet. It is a nickel-plated handgun.
"My name is Clayton, by the way. Let's go."

Departure Lounge
The frenetic pace, the hurried slew of bodies, the order and linearity have all devolved at the sound of gunfire: the main departure lounge is now a huddle of frightened bodies, spilled coffee, and abandoned luggage. The concourse proceeds west and east, and Gate Six is to your south.

Clayton is here, holding the ORBGROUP agent hostage.

You see a handgun on the ground.

The suited man huddles for cover nearby.

(type SURRENDER to give up)

>take handgun
You reach down and grab the handgun. It is heavy and cold.
"Good! Grab that man - we're getting out of here!" Clayton yells.
The suited man looks at you with pleading eyes. "Don't", he mouths silently to you.

A crash from the east concourse knocks you to the floor - smoke belches in from the east, and flickering flashlights are cutting bright planes in the oncoming cloud. You count five of them, and they are advancing fast.

"Shit," Clayton says. "I was afraid of that. Treasury sent a SWAT team." You can see him tighten the grip on his hostage. "You get your hostage and you get ready to move! We do this together or we're both dead."

(SURRENDER to give up, SHOOT to shoot someone)

>e
"Stop! Grab that hostage! That SWAT team will take you down in a heartbeat if you don't!" Clayton yells.

(SURRENDER to give up, SHOOT to shoot someone)

>e
"Stop! Grab that hostage! That SWAT team will take you down in a heartbeat if you don't!" Clayton yells.

Weaver finds you! He points his gun at you! "Drop to your knees! Get your hands behind your head!"
Clayton turns his head to look at the man. "Weaver," he hisses. He turns toward you. "Fuck that guy! He hasn't got the guts to do anything."

(SURRENDER to give up, SHOOT to shoot someone)

>shoot hostage
You put the man in your sights and squeeze the trigger.

*** BANG ***

You see the man collapse in a pool of blood on the ground.
Clayton looks at you, horrified. At last, he appears able to speak. "That - is fucking - wonderful. You're on your own, you fuck-up."

Weaver steadies his gun on you. "You're not getting out of here like this."

Clayton takes his hostage east.

(SURRENDER to give up, SHOOT to shoot someone)

>shoot weaver
You raise your handgun and lay the sights over Weaver.
He takes cover!

*** BANG ***
The bullet tears a chunk out of the tile near his head, missing him.

Weaver steadies his gun on you. "You're not getting out of here like this."

You hear the hammer of Weaver's gun click back. "Suspect! Do not try to escape! Get down on your knees and put your hands behind your head! Comply!"

(SURRENDER to give up, SHOOT to shoot someone)

>e
You follow Clayton to the east departure lounge.
You are confronted by a SWAT team staring you down from the east corner of the building where they have breached a ragged hole through the sculpture.

Departure Lounge East
The east lounge is a haze of chalky white smoke that chokes out your breathing and burns your eyes. At the end of the concourse you can barely see the droplet sculpture, split in half around a ragged, burnt hole drilled violently through the acrylic. Travelers here are lying flat on their stomachs, hands over their ears, waiting for the shots to stop. The rest of the lounge is back to your west. To your south is Gate Seven. A security monitor station is to the north.

Clayton is here, holding the ORBGROUP agent hostage.

A SWAT team has their guns sighted right on you!

A departure board hangs from the ceiling. 

"Target has no collateral", the SWAT team leader yells. You realize you have no hostage - nothing to protect you - and a gun in your hand! "Take him down!"

There is a rapid, ripping sound of gunfire from the east concourse, followed by ominous quiet. Calls for a medic and shouts of cleared sectors eventually fill in the silence. The SWAT team must have taken Clayton down.
 You know that they're coming for you next.

You hear a series of loud bangs as the SWAT team fires on you. The wind rushes out of your lungs as you crumple to the ground.

    *** You have been shot to death. ***

Would you like to RESTART, RESTORE a saved game or QUIT?

* * *

>e
You unlock the door and head back out to the food court.

Food Court
Things seem quiet in the food court now - maybe everyone has boarded for Gate Six.

The man drinking coffee has moved to another table.

I beg your pardon?

>s
You hear a click from behind you.
"Don't move", a voice says from the food court. "United States Treasury Department."
You freeze up - not sure if you should run or stay.
"That's good", the voice says behind you, finally coming around to face you. It is the man from the food court, now brandishing a compact pistol, and wearing a badge and earpiece. "We know you, but you don't know me. I'm Joseph Weaver, Financial Crimes Division." Weaver looks you in the eyes, but you find it hard not to stare at the little black pistol he points right at you.

Before he can say any more, an alarm sounds throughout the concourse.

"What the hell -" Weaver starts, but is interrupted by gunshots down the concourse to the east - followed closely behind by screams as travelers in the departure lounge panic at the shots.

You break from him and run south to the departure lounge!

You can see Weaver catching up with you! You had better get out of here.

Departure Lounge West
The recent gunfire has transformed the departure lounge into a river of panic - travelers are diving for cover, rapidly yelling to emergency services on mobile phones, or trying to find ways out of the terminal without exposing themselves to further harm. The scene is chaos - every traveler is out for themselves.You can see the rest of the departure lounge concourse to the east, and Gate Five is to the south.

(type SURRENDER to give up)

* * *

>s
"Hey!" Clayton yells as you run south. "Hey, get back here, goddamn-"A hail of gunfire drowns his words out.

Gate 6
Gate Six is absolutely empty of life. No agent, no travelers - nothing. The panic has driven travelers to the far east and far west gates, leaving this middle gate barren.Gate Five is to the west, Gate Seven to the east, and the departure lounge is to the north. The jetdoor blocks access to a jet bridge to the south.

You can see a jetdoor and a pass reader (empty) here.

(SURRENDER to give up, SHOOT to shoot someone)

>put pass in reader
(the boarding pass in the pass reader)
The reader sucks down the pass, and the jetdoor in front of you unseals with a spout of gas from the depressurization rig. Now open, the jetdoor access light is green. You're cleared to enter the jetbridge to your south.

(SURRENDER to give up, SHOOT to shoot someone)

>s
You make a break for the open jetdoor!
You hear the man north of you, yelling! "Come back, damn you! Don't get on that -"His words are drowned out in a burst of automatic gunfire.
You keep your head down and run...

You make it into the jetbridge, breathless - but Weaver is still coming for you. You look around you...

Jetbridge
You can see a jetdoor and a pressurization panel (closed) here.

There is a rapid, ripping sound of gunfire from the east concourse, followed by ominous quiet. Calls for a medic and shouts of cleared sectors eventually fill in the silence. The SWAT team must have taken Clayton down.
 You know that they're coming for you next.

(SURRENDER to give up, SHOOT to shoot someone)

>close jetdoor
You close the jetdoor.

(SURRENDER to give up, SHOOT to shoot someone)

>open panel
You open the pressurization panel, revealing an emergency pressure handle.

(SURRENDER to give up, SHOOT to shoot someone)

>pull handle
You yank at the handle...

The whole thing comes off in your hand; you slam back against the wall as a yellow light flares from above and a blast of escaping gas rushes down the jetbridge corridor.
 The light turns red - you see a wheel mechanism inside the jetdoor turn and lock into place.
 You have sealed the jetdoor closed. Gunshots ring out from the airport side of the door, but they are barely audible.

>look
Jetbridge
You can see a jetdoor and a pressurization panel (empty) here.

There is a clatter at the jetdoor, and voices yelling for you to surrender - but they are unable to get the pressurized door open.

>look at jetdoor
The jetdoor is a heavy-looking spinelock affair, with a sterile-white depressurization rig attached to the side. It is closed, a blood-red light pulsing slowly above the door frame.

Weaver slams up against the jetdoor, cursing out loud, trying to get through, but the jetdoor has pressurized and locked down.

You are safe for now.

You drop the handle to the floor and take a breath.
A meek voice to your south calls out: "Hello?

Jetbridge
The jetbridge now feels like a portal to another world, the solid slab of the jetdoor an absolute barrier between the near-death of the concourse and your own fragile body. Sounds from the concourse are muffled, far-off, and unable to get to you.
 To your south, you see the open door to the ORBFLIGHT aircraft, waiting for you to board.

You can see a jetdoor and a pressurization panel (empty) here.

>s
You walk down the jetbridge, into the cabin of the waiting aircraft.

You try, as covertly as you can, to drop the handgun in the jetbridge as you board.
The ORBFLIGHT crew, waiting in the cabin, welcomes you aboard, acting as if they hadn't realized - or were simply kind enough to ignore - that you had run through a monsoon of bullets to get here.
The attendant shows you to your harness module and makes the usual motions to instruct you on emergency release procedures in the case of zero-atmosphere depressurization, gimbal lock, and solar flares.
At last, she drops the latest Zink in your lap and smiles, checking that your harness is buckled and that you're ready to head up.

ORBFLIGHT Cabin
You are seated in a deep leather reclining seat, looking out a fist-sized porthole to the world outside. The ORBFLIGHT cabin is a small, leather and granite-style paneled hemisphere with a handful of similar seats, each one containing a similarly disconnected, quiet traveler. The ceiling of the cabin is a stylized celestial map.
The cabin exits to the outside, east.

The ORBGROUP flight attendant walks the cabin, making sure things are in order.

A complicated force harness keeps you buckled into your seat.

A PAXET display hinges out from your seat, waiting for a command.

The latest Zink magazine is here.

>look
ORBFLIGHT Cabin
You are seated in a deep leather reclining seat, looking out a fist-sized porthole to the world outside. The ORBFLIGHT cabin is a small, leather and granite-style paneled hemisphere with a handful of similar seats, each one containing a similarly disconnected, quiet traveler. The ceiling of the cabin is a stylized celestial map.
The cabin exits to the outside, east.

The ORBGROUP flight attendant walks the cabin, making sure things are in order.

A complicated force harness keeps you buckled into your seat.

A PAXET display hinges out from your seat, waiting for a command.

The latest Zink magazine is here.

>look at zink
You see nothing special about the Zink magazine.

>look at display
The PAXET display reads INSERT LOGOSTICK and appears ready to operate.

>look at harness
The harness is a remote-release ORBGROUP-standard five-point acceleration model, designed to keep you safe and secure while the ORBGROUP flight makes initial ascent and final descent.
The harness is secure around your shoulders, keeping you tight to the seat.A light on the buckle glows red, indicating it has been remotely locked.

>look at porthole
NO ON-GROUND DESCRIPTION

>look at map
NO ON-GROUND DESCRIPTION

A low rumbling from somewhere outside draws your attention to the south windows of the departure lounge. You watch through the glass, and through and a haze of precautionary fire retardant glowing red from emergency lighting.

 A large mesh hoop is being drawn up to a forty-five degree angle out on the tarmac.

 The rumble grows, expands, splitting the air, layer after layer of fracturing, crackling screams. You see some of the travelers opening their mouths, stuffing their earphones deeper in their ears.

 The windows flex, pulse, vibrate. The sound grows unbearably loud - in an instant, there is a final whipcrack and the hoop is flexed to bursting, cradling a steaming, charred dart the size of a school bus.

 A voice comes over the lounge intercom: "Whitmore Executive announces the arrival of flight 2A2, with service to Alexandria, Virginia, United States. This flight is now boarding at Gate Six.

>look
ORBFLIGHT Cabin
You are seated in a deep leather reclining seat, looking out a fist-sized porthole to the world outside. The ORBFLIGHT cabin is a small, leather and granite-style paneled hemisphere with a handful of similar seats, each one containing a similarly disconnected, quiet traveler. The ceiling of the cabin is a stylized celestial map.
The cabin exits to the outside, east.

The ORBGROUP flight attendant walks the cabin, making sure things are in order.

A complicated force harness keeps you buckled into your seat.

A PAXET display hinges out from your seat, waiting for a command.

The latest Zink magazine is here.

>look
ORBFLIGHT Cabin
You are seated in a deep leather reclining seat, looking out a fist-sized porthole to the world outside. The ORBFLIGHT cabin is a small, leather and granite-style paneled hemisphere with a handful of similar seats, each one containing a similarly disconnected, quiet traveler. The ceiling of the cabin is a stylized celestial map.
The cabin exits to the outside, east.

The ORBGROUP flight attendant walks the cabin, making sure things are in order.

A complicated force harness keeps you buckled into your seat.

A PAXET display hinges out from your seat, waiting for a command.

The latest Zink magazine is here.

>look
ORBFLIGHT Cabin
You are seated in a deep leather reclining seat, looking out a fist-sized porthole to the world outside. The ORBFLIGHT cabin is a small, leather and granite-style paneled hemisphere with a handful of similar seats, each one containing a similarly disconnected, quiet traveler. The ceiling of the cabin is a stylized celestial map.
The cabin exits to the outside, east.

The ORBGROUP flight attendant walks the cabin, making sure things are in order.

A complicated force harness keeps you buckled into your seat.

A PAXET display hinges out from your seat, waiting for a command.

The latest Zink magazine is here.

You hear the overhead intercom go on. A curt, edged voice comes on the line.
"Welcome to ORBGROUP flight TWO-ALPHA-TWO, service from Johannesburg, South Africa to Alexandria, Virginia in the United States. We're uh - just coming off a bit of trouble in the terminal, but that's not our concern at the moment. ORBGROUP has told us that our safest option right now is to hook up and get skyborne. Your ORBGROUP in-can flight officers Trieste and Mercer here, letting you know today's orbital operators are on loan from Conica, who reminds you that space is a journey, not a destination."
You can hear quiet conversation in the cockpit. Finally the intercom comes back on.
"We're expecting to hook up in about ten minutes, at which point we're looking at a five-minute trip up, a fifteen-minute float, and ten minutes burn to land at Alexandria, putting you on the ground at just around two-thirty AM, Eastern time."
"Conica is indicating we're eight minutes from first hookup burn, so please stay in those harnesses and we'll get you weightless just as soon as we can. Thanks for coming along with us here at ORBGROUP."

>look
ORBFLIGHT Cabin
You are seated in a deep leather reclining seat, looking out a fist-sized porthole to the world outside. The ORBFLIGHT cabin is a small, leather and granite-style paneled hemisphere with a handful of similar seats, each one containing a similarly disconnected, quiet traveler. The ceiling of the cabin is a stylized celestial map.
The cabin exits to the outside, east.

The ORBGROUP flight attendant walks the cabin, making sure things are in order.

A complicated force harness keeps you buckled into your seat.

A PAXET display hinges out from your seat, waiting for a command.

The latest Zink magazine is here.

* * *

>SCENES
Scene 'Entire Game' playing (for 0 mins now)
Scene 'Armistice Day' playing (for 0 mins now)
(Scene monitoring now switched on. Type "scenes off" to switch it off again.)

>xyzzq
Argot Lounge
Blah blah. The wall is displaying a crucifixion-crucifixion diorama, the ceiling above you is displaying a crucifixion-crucifixion diorama, and the floor at your feet is displaying a crucifixion-crucifixion diorama.

[Scene 'Alexandria Day One' begins]

>look
Argot Lounge
Blah blah. The wall is displaying a competitive chess-classical leitmotif corpus, the ceiling above you is displaying a antigravity-grain price diorama, and the floor at your feet is displaying a japanese fashion-classical leitmotif diorama.

You feel a pain in your left leg.

* * *

>xyzzq
Argot Lounge
Blah blah. The wall is displaying a crucifixion-crucifixion diorama, the ceiling above you is displaying a crucifixion-crucifixion diorama, and the floor at your feet is displaying a crucifixion-crucifixion diorama.

>change it
As if by magic, the patterns around the room change to your command.

You feel a pain in your left leg.

>look
Argot Lounge
Blah blah. The wall is displaying a bird migration-japanese fashion diorama, the ceiling above you is displaying a coriolis effect-heliography hologram, and the floor at your feet is displaying a heraldry-grain price mimeograph.

>change it
As if by magic, the patterns around the room change to your command.

You're growing increasingly aware of the pain in your left leg.

>look
Argot Lounge
Blah blah. The wall is displaying a antigravity-winter climate hologram, the ceiling above you is displaying a norse mythos-currency hologram, and the floor at your feet is displaying a heliography-judicial opinion diorama.

>look
Argot Lounge
Blah blah. The wall is displaying Three, the ceiling above you is displaying Four, and the floor at your feet is displaying Five.

>change it
As if by magic, the patterns around the room change to your command.

>look
Argot Lounge
Blah blah. The wall is displaying Two, the ceiling above you is displaying One, and the floor at your feet is displaying Two.

>change it
As if by magic, the patterns around the room change to your command.

The pain in your leg is excruciating. You're starting to feel sick. You're going to need medical help soon.

>look
Argot Lounge
Blah blah. The wall is displaying Two, the ceiling above you is displaying Four, and the floor at your feet is displaying One.

* * *

>look
Argot Lounge
Blah blah. The wall is displaying a bird migration-japanese fashion diorama, the ceiling above you is displaying a coriolis effect-heliography hologram, and the floor at your feet is displaying a heraldry-grain price mimeograph.

>look at floor
The floor is a holographic image of a Japanese noh-style wakizure gliding down a fashion runway, with a bleeding left eye, joined with a graphical breakout chart of grain sales radiating from major food centers.

You're growing increasingly aware of the pain in your left leg.

>look at wall
The surface of the wall contains a matchwork pattern of Christ-like figures, overlaid on a matrix of melted wax droplets revealing a message within the pixels of an image.

>look at ceiling
Looking up at the ceiling, you see a blob of pyramidial currency chits, rotating around a series of numerical buckets receiving individual words from a floating document.

>change it
As if by magic, the patterns around the room change to your command.

>look
Argot Lounge
Blah blah. The wall is displaying a crucifixion-currency mimeograph, the ceiling above you is displaying a crucifixion-crucifixion corpus, and the floor at your feet is displaying a grain price-crucifixion diorama.

>look at ceiling
Looking up at the ceiling, you see a matchwork pattern of Christ-like figures, overlaid on a matchwork pattern of Christ-like figures.

The pain in your leg is excruciating. You're starting to feel sick. You're going to need medical help soon.

>change it
As if by magic, the patterns around the room change to your command.

>look
Argot Lounge
Blah blah. The wall is displaying a grain price-steganography diorama, the ceiling above you is displaying a japanese fashion-japanese fashion corpus, and the floor at your feet is displaying a steganography-japanese fashion diorama.

>change it
As if by magic, the patterns around the room change to your command.

>look
Argot Lounge
Blah blah. The wall is displaying a grain price-grain price mimeograph, the ceiling above you is displaying a japanese fashion-steganography corpus, and the floor at your feet is displaying a currency-currency mimeograph.

>change it
As if by magic, the patterns around the room change to your command.

>look
Argot Lounge
Blah blah. The wall is displaying a stylometry-stylometry triptych, the ceiling above you is displaying a currency-grain price hologram, and the floor at your feet is displaying a grain price-steganography mimeograph.

>look at floor
The floor is a holographic image of a graphical breakout chart of grain sales radiating from major food centers, enmeshed in a matrix of melted wax droplets revealing a message within the pixels of an image.

>look
Argot Lounge
Blah blah. The wall is displaying a stylometry-stylometry triptych, the ceiling above you is displaying a currency-grain price hologram, and the floor at your feet is displaying a grain price-steganography mimeograph.

* * *

>xyzzq
Argot Lounge
Blah blah. The wall is displaying a crucifixion-crucifixion diorama, the ceiling above you is displaying a crucifixion-crucifixion diorama, and the floor at your feet is displaying a crucifixion-crucifixion diorama.

>look at data wall
Blah

You feel a pain in your left leg.

* * *

>xyzzq
Argot Lounge
Blah blah. The wall is displaying a crucifixion-crucifixion diorama, the ceiling above you is displaying a crucifixion-crucifixion diorama, and the floor at your feet is displaying a crucifixion-crucifixion diorama.

>look
Argot Lounge
Blah blah. The wall is displaying a heraldry-antigravity hologram, the ceiling above you is displaying a signal bleed-signal bleed diorama, and the floor at your feet is displaying a antigravity-tectonics hologram.

You feel a pain in your left leg.

>SCENES
Scene 'Entire Game' playing (for 2 mins now)
Scene 'Armistice Day' playing (for 2 mins now)
Scene 'Alexandria Day One' playing (for 2 mins now)
(Scene monitoring now switched on. Type "scenes off" to switch it off again.)

>change it
As if by magic, the patterns around the room change to your command.

[Scene 'Alexandria Day One' ends]

>look
Argot Lounge
Blah blah. The wall is displaying a artillery grid-winter climate corpus, the ceiling above you is displaying a biathlon-crucifixion hologram, and the floor at your feet is displaying a spring climate-coriolis effect hologram.

You're growing increasingly aware of the pain in your left leg.

>e
You can't go that way.

>w
You can't go that way.

>s
You can't go that way.

>n
You can't go that way.

* * *

>xyzzq
Argot Lounge
Blah blah. The wall is displaying a crucifixion-crucifixion diorama, the ceiling above you is displaying a crucifixion-crucifixion diorama, and the floor at your feet is displaying a crucifixion-crucifixion diorama.

>look at wall
The surface contains a matchwork pattern of Christ-like figures rotating around pyramidial currency chits.

You feel a pain in your left leg.

>xyzzy
Departure Lounge
People surround you; hurried, frayed, fast. Glass and steel beamwork cross in sweeping orbits around a large curved window that looks out over a greenbelted cityscape. The smell of hastily-fried foods mixed with heavy coffees. Black leather chairs embossed with friendly ORBGROUP logos line the main thoroughfare; white tile floors cut by vanishing-point aluminum slices extend on to the west and east until they curve out of sight. To your south is Gate Six.

There is a suited man here, busy on his phone.

-- (LOG) $82 $2 -- (CIA) $89 $9 -- (YOU) $49 $-1 -- 
Symbol ----- Name ------ Price | +/-
LOG | LogoS Corporation | $82  | $2
CIA | Clayton Info.Acq. | $89  | $9
YOU | You, Incorporated | $49  | $-1

>xyzzq
Argot Lounge
Blah blah. The wall is displaying a sort of currency crucifixion diorama.

>look at ceiling
The surface contains a matchwork pattern of Christ-like figures rotating around pyramidial currency chits.

* * *

>look at locker
The locker sits just under the numbers on the wall.

Aha! The locker looks sheared off a bit on one edge, the resultant hole revealing a glint of metal inside.

>open shear
You pull the rest of the metal away from the shear to make an opening - you're pretty sure your hand can reach the lock from the inside now.

You open the fire locker, revealing an extinguisher and a fire hose.

You feel a pain in your left leg.

>get extinguisher
Taken.

>get hose
You yank on the hose, spinning it off the spool.

Taken.

You're growing increasingly aware of the pain in your left leg.

>attack handrail with extinguisher
You raise up the extinguisher and bring it down hard on the handrail.

You hear the wood crack and give a little.

>attack handrail with extinguisher
You raise up the extinguisher again, groaning with the effort, and bring it down on the rail.

The wooden rail gives out a loud report. You can see an ugly crack forming lengthwise along the grain of the wood.

>attack handrail with extinguisher
You can barely lift up the extinguisher for a third time. With shaking arms, you raise it up and bring it down on the rail as hard as you can.

With a lound bang, everything goes white.

You are covered in aqueous foam. The extinguisher has shot off somewhere down into the lower floors, no doubt self-propelled by the foam that's now pouring out of it at high velocity.

But, the job has been done - you notice that the handrail has split and left a long slat within reach.

>get slat
Taken.

>fix leg with slat
This just might work - you put the slat against your leg, locking your knee in place.

 While holding it down, you wrap the fire hose around your leg and the slat. It hurts - you can already see blood oozing out from the flaps of the hose.

 You manage to get the wraps all the way around. You can't find anywhere to fit the nozzle - it drapes clumsily from your leg - but otherwise it's not a bad job. You're standing, at least: wobbly, but standing.

>up
You fix your sights on the ten steps in front of you between here and the door - you realize the only way you're going to make it is to charge the stairs before your makeshift splint gives out. You take a breath, and go.

Forty-Fifth Floor Breezeway
As you crash the fire door at the top of the stairs, you are hit by an autumn squall - you've made it out of the building onto a breezeway, and the wind up here is at storm velocity. The breezeway is a high modern arch, cresting over a series of transmission spikes glowing a dull red against the driving rain. It extends north toward a small observation annex.

Through the dark gray trunks of concrete on the breezeway, you can see far-flung fireworks exploding in the distance over the city.

A door leads back down to the staircase landing on the forty-fourth floor.

 A service gate marked by a sign is to the east and looks to lead underneath the breezeway structure.

>look
Forty-Fifth Floor Breezeway
The breezeway is a high modern arch, cresting over a series of transmission spikes glowing a dull red against the driving rain. It extends north toward a small observation annex.

Through the dark gray trunks of concrete on the breezeway, you can see far-flung fireworks exploding in the distance over the city.

A door leads back down to the staircase landing on the forty-fourth floor.

 A service gate marked by a sign is to the east and looks to lead underneath the breezeway structure.

>down
You look at the staircase leading back down to the landing, and your splinted leg throbs in sympathetic pain, oozing another blot of blood onto your bandage. The pain and the blood convince you that more vertical movement is too risky right now.

>n
Observation Annex
The observation annex of the Bastille Building is a mollusk-like protrusion off the north end of the building, comprising a large, coif-like curved wind scoop and an offset crescentform ledge where you stand now, looking out over the city, sheltered from the wind and rain by a glass shield.

You can see your reflection in a small but polished plaque that is mounted on the observation shield. Something is odd about your reflection.

>look at reflection
You approach the glass wall that separates you from the city, hoping to get a glimpse of yourself - something more than your clothes and your hands - in the plaque that is affixed there.

You stop short.

Something is wrong with your face.

>look at face
As you inch up to the glass to see yourself better, you get a twisting feeling in your stomach - instead of a familiar blue and white eyeball staring back at you from the right side of your face, there's only a hollow, ink-black pit.

Your right eye is gone. It is completely gone. Not even a trickle of blood traces back to the hole.

You stumble, faint and dead-sick at the sight. They've taken your eye - someone carved it out of your head. As your remaining eye focuses on the plaque:

BASTILLE BUILDING CA. 2121
"PLANT, AND REAP THE BOUNTY OF EARTH"
COMMITTED TO US THIS ARMISTICE DAY BY:

You realize that your name is inscribed below.

This was your building, those many years ago.

So many years ago.

You fall to the concrete in pain and shock.

Somewhere out there, you can hear more fireworks exploding against the cityscape as the world fades, being sucked down through the hole where your eye used to be, draining into your brain...

Superego
It's cold here.

>e
You can't. You don't have the strength right now.

...life always looked like a straight line - especially back when they looked at the City of Industry and they saw salvation...
 ...then came the day the world split into two choices; you realized there were people with more at stake than you anticipated...

>w
You can't. You don't have the strength right now.

...everybody knew you - everybody loved you - everybody asked for your opinion, your consideration in reforming the Industry, the new Economy...
 ...and still they came. At first, you placated them; treated them like any other interested party wanting a handout; a cop at a border crossing...

>e
You can't. You don't have the strength right now.

...but they were unlike anyone you had ever met. They simply refused to melt into the rest of the Industry fog...
 ...their words started to feel like your words, yours like theirs, and what you could only forecast, they seemed to know...

>e
You can't. You don't have the strength right now.

...but you had the last act already written...
...how could they do this to you?

Departure Lounge
People surround you; hurried, frayed, fast. Glass and steel beamwork cross in sweeping orbits around a large curved window that looks out over a greenbelted cityscape. The smell of hastily-fried foods mixed with heavy coffees. Black leather chairs embossed with friendly ORBGROUP logos line the main thoroughfare; white tile floors cut by vanishing-point aluminum slices extend on to the west and east until they curve out of sight. To your south is Gate Six.

There is a suited man here, busy on his phone.

>w
Departure Lounge West
The colors grow increasingly more saturated here in the west end of the departure lounge. The stark whites and metallic tones grow whimsical, with red paneling and green accents on the walls, flowing like tendrils out of the food court to the north. You can see the rest of the departure lounge concourse to the east, and Gate Five is to the south.

>e
Departure Lounge
There is a suited man here, busy on his phone.

>w
Departure Lounge West

>e
Departure Lounge
There is a suited man here, busy on his phone.

>e
Departure Lounge East
The East lounge terminates in a spheroid droplet sculpture molded into the flesh of the building, casting a warped and eerie light from a bright, early morning onto the tile below your feet. The travelers that wait here seem anxious, strained for something, wearing unfocused expressions and slack ties. The rest of the lounge is back to your west. To your south is Gate Seven. A security monitor station is to the north.

A departure board hangs from the ceiling.

>e
You can't go that way.

>w
Departure Lounge
There is a suited man here, busy on his phone.

>w
Departure Lounge West

>w
You can't go that way.

>e
Departure Lounge
There is a suited man here, busy on his phone.

>e
Departure Lounge East
A departure board hangs from the ceiling.

>w
Departure Lounge
There is a suited man here, busy on his phone.

>open envelope
You open the envelope, revealing a ticket and a letter.

>take ticket
Taken.

>read letter
The letter is a typed memo with the letterhead of a company: LogoS. You know them well, and their President, Jonathan French.

It is his signature that completes the following letter:

My Friend - 

Rare in my experience is a man who faces a set of circumstances such as you face now.

If you don't yet understand, you can trust me at least to help you see more clearly; LogoS is nothing if not the first to know in matters relational, and you can be assured: we know who mutilated you, who is to be blamed for your near-death in the City of Industry.

Understand, though: information cuts both ways, and we know the ruse you were playing as part of your Gas Temple campaign. Your deception was interrupted, and while not entirely exposed, your intentions were made clear to a few. We therefore know something about you, as well as your assailants.

To be sure, this would indicate two markers of advantage to us and none to you, but as I hinted earlier, your circumstances are exceptional. There is a service you can do for us, and to that end, you have received both an expedient exfiltration from the City, far enough away to hide our tracks, and as much medical care as we could administer enroute, so that you may be well enough to join us at our corporate center in Alexandria.

You have the necessary ticket for a suborbital flight on your person and my very best wishes for a safe and expedient trip up and over. Certainly, if you choose not to hear us out, we can't be blamed for any leakages of your personal affront to your own shareholders, let alone the law. Acher and The Priests may be old and slow, but a disgruntled market will shoulder them along to your door without much delay.

I add only that though our efforts have been both expedient and clandestine, there will be others with much at stake asking your whereabouts, and who may be in your midst now despite our precautions. If you are to act, be swift. You are by no means out of danger yet.

I remain yours very truly,

Jonathan French
President, LogoS Board of Directors

>w
Departure Lounge West

>e
Departure Lounge
There is a suited man here, busy on his phone.

A low rumbling from somewhere outside draws your attention to the south windows of the departure lounge. You watch through the glass, and through and a haze of precautionary fire retardant glowing red from emergency lighting.

 A large mesh hoop is being drawn up to a forty-five degree angle out on the tarmac.

 The rumble grows, expands, splitting the air, layer after layer of fracturing, crackling screams. You see some of the travelers opening their mouths, stuffing their earphones deeper in their ears.

 The windows flex, pulse, vibrate. The sound grows unbearably loud - in an instant, there is a final whipcrack and the hoop is flexed to bursting, cradling a steaming, charred dart the size of a school bus.

 A voice comes over the lounge intercom: "Whitmore Executive announces the arrival of flight 2A2, with service to Alexandria, Virginia, United States. This flight is now boarding at Gate Six.

>w
Departure Lounge West

* * *

>e
Departure Lounge
There is a suited man here, busy on his phone.

>s
Gate 6
Gate Six is empty in comparison to the other two gates. Either a flight just departed from this gate or nobody is interested in the next flight. The window has a view of the tarmac, where you can see ground crews scurrying about, readying for an arrival or a departure. Gate Five is to the west, Gate Seven to the east, and the departure lounge is to the north. The jetdoor blocks access to a jet bridge to the south.

You can see a jetdoor, an ORBGROUP gate agent and a pass reader (empty) here.

>e
Gate 7
This gate, lit in wide, langorous strips by the refracted sunlight through the droplet carved into the East lounge, is filled with haggard business travelers, many of whom have resigned themselves to a long wait, as evidenced by rolled-up sleeves, loosened ties, and half-full cups of coffee stacked within emptied cups, a stack for each traveler. The ORBGROUP ticketing station is unmanned, and the gate's jetdoor indicator glows a solid, lazy red. The departure lounge is back to the north. Gate Six is to the west.

You see a man working on a laptop.

>w
Gate 6
You can see a jetdoor, an ORBGROUP gate agent and a pass reader (empty) here.

>talk to agent
The agent looks at you, trying to gauge something.
 "Are you our last passenger? We've been calling you. Ticket, please."

>give ticket to agent
You hand over your ticket to the agent, who takes it as you pass through a bioscanner. You see a red light go on above your head and a hand stops you from going any further, resting firmly against your chest.

 "Sir," the agent says at last, with a measured, slow voice, removing his hand, "Your right eye is a prosthetic, isn't it?"

 "I - " you manage, your hand edging up toward your face in embarassed reflex.

 "We're required to tell you, Sir," the agent continues, "that prosthetic eyes are not allowed on any ORBGROUP flight. They have the habit of becoming projectiles when the entry vehicle decelerates."

 You hesitate, unsure what to say next.

 The agent has already calmly printed out a boarding pass and handed it to you. "ORBGROUP policy - if you would head to the restrooms and remove the prosthetic before flight. Sir."

 "You want me to take my own eye out?" you ask.

 "The restrooms are in the food court, just north of Departure Lounge West, Sir. And if you could hurry, Sir. We're fueled and ready to clear the gate." The agent returns to the scanner, leaving you with the pass.

>n
Departure Lounge
There is a suited man here, busy on his phone.

>w
Departure Lounge West

>n
Food Court
The food court is a cascade of colors that emphasize poor judgment and the very latest horizontal combination services - surrounding you are a sea of coffeeweb shops, newsrental kiosks, burger-photo restaurants, astromedical prediction booths, and rapidbank-legal question-and-answer selfservice units. In the middle of the food court are a disorganized pile of seats and tables, peppered with tray and trash stations.

To the south, you can see the departure concourse. To the west, there's a hallway marked with a restroom sign.

You see a man drinking coffee.

>w
The restroom is a one-person affair. You enter and lock the door behind you.

Restroom
You look around the tiny restroom. It was made for the comfort of one person; the room is set out in dark marbles with Chinoise accent. The motion detector has already triggered a dim recessed panel of lighting, and you can see the basics of the room in fuzzy relief around you.

You see your reflection in the mirror.

You can also see a sink and a toilet here.

>take out eye
You aren't really sure how to do this - you always hated anything getting close to your eyes...but you're running out of time to catch your flight....

 You try to pinch the eye with one hand while keeping your lid open with the other -

 Whoops! The eye falls into your hand. It's a hull, not a sphere like you imagined. It's hard like glass, and cold.
 Wait a minute. On the back there's some kind of tape or film.
 You carefully peel it off.

>wash film in sink
You turn the spigot on the sink and let the water run over the film.

You scrub at the thin film a bit.

You pull the film back and take a look at it. Looks clean - there's something written on it.

>read film
On the film is written the following words:

DO NOT GET ON THE PLANE

>e
You unlock the door and head back out to the food court.

Food Court
Things seem quiet in the food court now - maybe everyone has boarded for Gate Six.

The man drinking coffee has moved to another table.

* * *

>take hostage
You cock the hammer back on your handgun and grab the man by his collar. Shrieking, he backpedals right into you. You feel his back slam against your chest, and your arm crooks around him to keep him close.

 You swallow and close your eyes, putting your gun to his head, trying to convince yourself you're only doing this to survive.

 Just to survive.

"Okay," Clayton says, turning his hostage to face the incoming SWAT team. He cranes his head over your way. "We're making our move now! Let's go!"
Clayton takes his hostage east.

(SURRENDER to give up, SHOOT to shoot someone)

* * *

>s
"Hey!" Clayton yells as you run south. "Hey, get back here, goddamn-"A hail of gunfire drowns his words out.

Gate 6
Gate Six is absolutely empty of life. No agent, no travelers - nothing. The panic has driven travelers to the far east and far west gates, leaving this middle gate barren.Gate Five is to the west, Gate Seven to the east, and the departure lounge is to the north. The jetdoor blocks access to a jet bridge to the south.

You can see a jetdoor and a pass reader (empty) here.

A crash from the east concourse knocks you to the floor - smoke belches in from the east, and flickering flashlights are cutting bright planes in the oncoming cloud. You count five of them, and they are advancing fast.

(type SURRENDER to give up)

>put pass in reader
(the boarding pass in the pass reader)
The reader sucks down the pass, and the jetdoor in front of you unseals with a spout of gas from the depressurization rig. Now open, the jetdoor access light is green. You're cleared to enter the jetbridge to your south.

(type SURRENDER to give up)

>s
You make a break for the open jetdoor!
You hear the man north of you, yelling! "Come back, damn you! Don't get on that -"His words are drowned out in a burst of automatic gunfire.
You keep your head down and run...

You make it into the jetbridge, breathless - but Weaver is still coming for you. You look around you...

Jetbridge
You can see a jetdoor and a pressurization panel (closed) here.

There is a rapid, ripping sound of gunfire from the east concourse, followed by ominous quiet. Calls for a medic and shouts of cleared sectors eventually fill in the silence. The SWAT team must have taken Clayton down.
 You know that they're coming for you next.

(type SURRENDER to give up)

>close jetdoor
You close the jetdoor.

(type SURRENDER to give up)

>open panel
You open the pressurization panel, revealing an emergency pressure handle.

(type SURRENDER to give up)

>pull handle
You yank at the handle...

The whole thing comes off in your hand; you slam back against the wall as a yellow light flares from above and a blast of escaping gas rushes down the jetbridge corridor.
 The light turns red - you see a wheel mechanism inside the jetdoor turn and lock into place.
 You have sealed the jetdoor closed. Gunshots ring out from the airport side of the door, but they are barely audible.

* * *

>look
Jetbridge
You can see a jetdoor and a pressurization panel (empty) here.

There is a clatter at the jetdoor, and voices yelling for you to surrender - but they are unable to get the pressurized door open.

>look
Jetbridge
You can see a jetdoor and a pressurization panel (empty) here.

Weaver slams up against the jetdoor, cursing out loud, trying to get through, but the jetdoor has pressurized and locked down.

You are safe for now.

You drop the handle to the floor and take a breath.
A meek voice to your south calls out: "Hello?

Jetbridge
The jetbridge now feels like a portal to another world, the solid slab of the jetdoor an absolute barrier between the near-death of the concourse and your own fragile body. Sounds from the concourse are muffled, far-off, and unable to get to you.
 To your south, you see the open door to the ORBFLIGHT aircraft, waiting for you to board.

You can see a jetdoor and a pressurization panel (empty) here.

>look
Jetbridge
The jetbridge now feels like a portal to another world, the solid slab of the jetdoor an absolute barrier between the near-death of the concourse and your own fragile body. Sounds from the concourse are muffled, far-off, and unable to get to you.
 To your south, you see the open door to the ORBFLIGHT aircraft, waiting for you to board.

You can see a jetdoor and a pressurization panel (empty) here.

>s
You walk down the jetbridge, into the cabin of the waiting aircraft.

The ORBFLIGHT crew, waiting in the cabin, welcomes you aboard, acting as if they hadn't realized - or were simply kind enough to ignore - that you had run through a monsoon of bullets to get here.
The attendant shows you to your harness module and makes the usual motions to instruct you on emergency release procedures in the case of zero-atmosphere depressurization, gimbal lock, and solar flares.
At last, she drops the latest Zink in your lap and smiles, checking that your harness is buckled and that you're ready to head up.

ORBFLIGHT Cabin
You are seated in a deep leather reclining seat, looking out a fist-sized porthole to the world outside. The ORBFLIGHT cabin is a small, leather and granite-style paneled hemisphere with a handful of similar seats, each one containing a similarly disconnected, quiet traveler. The ceiling of the cabin is a stylized celestial map.
The cabin exits to the outside, east.

The ORBGROUP flight attendant walks the cabin, making sure things are in order.

A complicated force harness keeps you buckled into your seat.

A PAXET display hinges out from your seat, waiting for a command.

The latest Zink magazine is here.

>wait
Time passes.

>wait
Time passes.

>wait
Time passes.

You hear the overhead intercom go on. A curt, edged voice comes on the line.
"Welcome to ORBGROUP flight TWO-ALPHA-TWO, service from Johannesburg, South Africa to Alexandria, Virginia in the United States. We're uh - just coming off a bit of trouble in the terminal, but that's not our concern at the moment. ORBGROUP has told us that our safest option right now is to hook up and get skyborne. Your ORBGROUP in-can flight officers Trieste and Mercer here, letting you know today's orbital operators are on loan from Conica, who reminds you that space is a journey, not a destination."
You can hear quiet conversation in the cockpit. Finally the intercom comes back on.
"We're expecting to hook up in about ten minutes, at which point we're looking at a five-minute trip up, a fifteen-minute float, and ten minutes burn to land at Alexandria, putting you on the ground at just around two-thirty AM, Eastern time."
"Conica is indicating we're eight minutes from first hookup burn, so please stay in those harnesses and we'll get you weightless just as soon as we can. Thanks for coming along with us here at ORBGROUP."

>wait
Time passes.

>wait
Time passes.

The attendant near you smiles, folds down a chair from the cabin wall, and straps in with a harness, getting ready for launch.

>wait
Time passes.

>wait
Time passes.

A red light goes on above your head. At the same time, there is a whirring, flanging hum coming from beneath your seat.
You see the PAXET display retract into your seat as if it was taking cover.
The intercom clips on:"Flight attendants verify clips closed, ground locks disengage. Dry-fuel fuse is lit."
It's only then that you realize what an ORBFLIGHT really is, outside of standard travel for the rich and powerful: it's sitting just inches above a mountain of self-oxidizing micro-solar hydrogen fuel.
"Alexandria in a half-hour, folks. Here we go."
The fuel ignites.

ORBFLIGHT Cabin
Your head is crushed into your seat, unable to move - the rest of your body fares no better - you are accelerating faster, harder, than anything you have ever felt before, riding on a single solid chemical booster engine into the upper atmosphere. Your head, fixed in place as it is, fortunately has the porthole to look out at.

The ORBGROUP flight attendant sits calmly in a jumpseat, reading a magazine.

A complicated force harness keeps you buckled into your seat.

The Zink magazine is here, smeared flat against your chest.

>look at zink
With a monumental effort, you manage to move your head to look at the Zink magazine...

You see nothing special about the Zink magazine.

>look at porthole
With a monumental effort, you manage to move your head to look at the porthole...

NO IN-BOOST DESCRIPTION

>look at attendant
With a monumental effort, you manage to move your head to look at the ORBGROUP flight attendant...

WOAH NO DESCRIPTION!

>look
ORBFLIGHT Cabin
Your head is crushed into your seat, unable to move - the rest of your body fares no better - you are accelerating faster, harder, than anything you have ever felt before, riding on a single solid chemical booster engine into the upper atmosphere. Your head, fixed in place as it is, fortunately has the porthole to look out at.

The ORBGROUP flight attendant sits calmly in a jumpseat, reading a magazine.

A complicated force harness keeps you buckled into your seat.

The Zink magazine is here, smeared flat against your chest.

>look at porthole
With a monumental effort, you manage to move your head to look at the porthole...

NO IN-BOOST DESCRIPTION

>look
ORBFLIGHT Cabin
Your head is crushed into your seat, unable to move - the rest of your body fares no better - you are accelerating faster, harder, than anything you have ever felt before, riding on a single solid chemical booster engine into the upper atmosphere. Your head, fixed in place as it is, fortunately has the porthole to look out at.

The ORBGROUP flight attendant sits calmly in a jumpseat, reading a magazine.

A complicated force harness keeps you buckled into your seat.

The Zink magazine is here, smeared flat against your chest.

As you are becoming familiar - almost comfortable - with the forces mashing your head into your seat, you can hear the click of the intercom.
"Crew stand by for hookup and stage two acceleration."
Oh, for God's sake - 
The celestial map above you changes to a rapidly-draining timer and superimposed icon of a capsule - supposedly the aircraft you are riding in - suspended by a hook that hangs on a phantom line.
You can see nothing unusual outside, but know that the skyhook is approaching, tethered to a platform in near-earth orbit.
"Folks, headwinds have put us at a bit of a velocity disadvantage - we're looking at a bit of a bumpy hookup. If you'd do us a favor and keep your mouths open for just the next few seconds, you'll avoid any damage to your teeth on impact."
"Five - four -"
You open your mouth.
There is only the very slightest sound of steel whistling through sky, when an impact flattens you against your seat, the steel buckle of your harness stamping its mechanical imprint on your chest. Your jaw slams shut and your teeth crack against one another.
"Woah," goes the intercom. The celestial map announces "HOOKUP".

ORBFLIGHT Cabin
You can't breathe - you feel two-dimensional. The ORBFLIGHT you are sitting in is being flung into space by a huge slingsteel tether and orbit hook dangling from a low-earth satellite system. You try to remind yourself at some point this will all get better and your lungs will be able to inflate again. The porthole shows a rapidly-changing view. The celestial map above you has changed, too.

The ORBGROUP flight attendant appears to be asleep.

A complicated force harness keeps you buckled into your seat.

The Zink magazine has crawled up your chest and is apparently trying to choke you.

>look at magazine
With a monumental effort, you manage to move your head to look at the Zink magazine...

You see nothing special about the Zink magazine.

>look at harness
With a monumental effort, you manage to move your head to look at the harness...

The harness is a remote-release ORBGROUP-standard five-point acceleration model, designed to keep you safe and secure while the ORBGROUP flight makes initial ascent and final descent.
The harness is secure around your shoulders, keeping you tight to the seat.A light on the buckle glows red, indicating it has been remotely locked.

>look at attendant
With a monumental effort, you manage to move your head to look at the ORBGROUP flight attendant...

What a jerk.

>look
ORBFLIGHT Cabin
You can't breathe - you feel two-dimensional. The ORBFLIGHT you are sitting in is being flung into space by a huge slingsteel tether and orbit hook dangling from a low-earth satellite system. You try to remind yourself at some point this will all get better and your lungs will be able to inflate again. The porthole shows a rapidly-changing view. The celestial map above you has changed, too.

The ORBGROUP flight attendant appears to be asleep.

A complicated force harness keeps you buckled into your seat.

The Zink magazine has crawled up your chest and is apparently trying to choke you.

>look
ORBFLIGHT Cabin
You can't breathe - you feel two-dimensional. The ORBFLIGHT you are sitting in is being flung into space by a huge slingsteel tether and orbit hook dangling from a low-earth satellite system. You try to remind yourself at some point this will all get better and your lungs will be able to inflate again. The porthole shows a rapidly-changing view. The celestial map above you has changed, too.

The ORBGROUP flight attendant appears to be asleep.

A complicated force harness keeps you buckled into your seat.

The Zink magazine has crawled up your chest and is apparently trying to choke you.

>look
ORBFLIGHT Cabin
You can't breathe - you feel two-dimensional. The ORBFLIGHT you are sitting in is being flung into space by a huge slingsteel tether and orbit hook dangling from a low-earth satellite system. You try to remind yourself at some point this will all get better and your lungs will be able to inflate again. The porthole shows a rapidly-changing view. The celestial map above you has changed, too.

The ORBGROUP flight attendant appears to be asleep.

A complicated force harness keeps you buckled into your seat.

The Zink magazine has crawled up your chest and is apparently trying to choke you.

You feel the tension on your chest and neck melt away.
The sound of the rocket booster has faded as well - you are aware only of an incidental ringing left in your ears.
Breath returns to your lungs, blood once again flows to your brain. In fact, the whole of you seems to be light, rising, and free.
But it doesn't stop - you are rising from your seat, bound only by the harness. The magazine perched on your neck begins to float away, the pages flapping a little like wings.
"On behalf of the first officer, myself, and all our orbital flight crew," says the intercom, "Welcome to near-earth orbit and microgravity."

Terrific.

With a faint beep, your harness buckle goes from red to green.
The PAXET display that had gone underground during the pain and suffering of boost and hookup slowly extends from its hiding place, as if it were truly unaware anything had occurred.
"Folks, you're free to move about the cabin for a bit as we make the suborbital leg of our journey - the cabin attendants will be sure to get you seated and buckled in when we need to prepare for retro-fire. Enjoy, and thanks for traveling with ORBGROUP."

ORBFLIGHT Cabin
NO IN-ZERO DESCRIPTION

A PAXET display hinges out from your seat, waiting for a command.

The ORBGROUP flight attendant is awake, and watching travelers float about in zero-G.

A complicated force harness keeps you buckled into your seat.

The Zink magazine floats effortlessly in the air near your head.

>look at display
The PAXET display reads INSERT LOGOSTICK and appears ready to operate.

>insert logostick in display
You slot the logostick into the port in the side of the terminal, and it boots up silently.

PAXET Trunk - Welcome, You Inc.
TABLE OF MAIN OPTIONS

NEWS - Check latest news personalized for You, Inc.
STOCKS - Control your currently held stocks.
MESSAGES - Scan incoming messages
HELP - Get help with PAXET commands
EXIT - Exit PAXET and eject Logostick

-- (LOG) $80 $0 -- (CIA) $80 $0 -- (YOU) $50 $0 --

>exit
***PAXET SESSION TERMINATED***
You eject your logostick and the terminal blinks off.

ORBFLIGHT Cabin
NO IN-ZERO DESCRIPTION

A PAXET display hinges out from your seat, waiting for a command.

The ORBGROUP flight attendant is awake, and watching travelers float about in zero-G.

A complicated force harness keeps you buckled into your seat.

The Zink magazine floats effortlessly in the air near your head.

* * *

>look at display
The PAXET display reads INSERT LOGOSTICK and appears ready to operate.

>unclip harness
You open the harness.

>look
ORBFLIGHT Cabin
NO IN-ZERO DESCRIPTION

A PAXET display hinges out from your seat, waiting for a command.

The ORBGROUP flight attendant is awake, and watching travelers float about in zero-G.

The seat harness lies discarded, hanging from the seat.

The Zink magazine floats effortlessly in the air near your head.

>s
ORBFLIGHT Tailsection
NO IN-ZERO DESCRIPTION

>n
ORBFLIGHT Cabin
A PAXET display hinges out from your seat, waiting for a command.

The ORBGROUP flight attendant is awake, and watching travelers float about in zero-G.

The seat harness lies discarded, hanging from the seat.

The Zink magazine floats effortlessly in the air near your head.

>n
ORBFLIGHT Headsection
NO IN-ZERO DESCRIPTION

>s
ORBFLIGHT Cabin
A PAXET display hinges out from your seat, waiting for a command.

The ORBGROUP flight attendant is awake, and watching travelers float about in zero-G.

The seat harness lies discarded, hanging from the seat.

The Zink magazine floats effortlessly in the air near your head.

>flip
That's not a verb I recognise.

>jump
You jump on the spot, fruitlessly.

>help
That's not a verb I recognise.

>wait
Time passes.

I beg your pardon?

I beg your pardon?

>wait
Time passes.

You see the harness around you go red.

>wait
Time passes.

>look
ORBFLIGHT Cabin
NO IN-ZERO DESCRIPTION

A PAXET display hinges out from your seat, waiting for a command.

The ORBGROUP flight attendant is awake, and watching travelers float about in zero-G.

A complicated force harness keeps you buckled into your seat.

The Zink magazine floats effortlessly in the air near your head.

>look
ORBFLIGHT Cabin
NO IN-ZERO DESCRIPTION

A PAXET display hinges out from your seat, waiting for a command.

The ORBGROUP flight attendant is awake, and watching travelers float about in zero-G.

A complicated force harness keeps you buckled into your seat.

The Zink magazine floats effortlessly in the air near your head.

>look
ORBFLIGHT Cabin
NO IN-ZERO DESCRIPTION

A PAXET display hinges out from your seat, waiting for a command.

The ORBGROUP flight attendant is awake, and watching travelers float about in zero-G.

A complicated force harness keeps you buckled into your seat.

The Zink magazine floats effortlessly in the air near your head.

The PAXET Display slides back into its holder again.
RETRO, BABY!

>look
ORBFLIGHT Cabin
NO IN-RETRO DESCRIPTION

The ORBGROUP flight attendant is awake, and watching travelers float about in zero-G.

A complicated force harness keeps you buckled into your seat.

The Zink magazine is here, smeared flat against your chest.

>look at harness
With a monumental effort, you manage to move your head to look at the harness...

The harness is a remote-release ORBGROUP-standard five-point acceleration model, designed to keep you safe and secure while the ORBGROUP flight makes initial ascent and final descent.
The harness is secure around your shoulders, keeping you tight to the seat.A light on the buckle glows red, indicating it has been remotely locked.

>look
ORBFLIGHT Cabin
NO IN-RETRO DESCRIPTION

The ORBGROUP flight attendant is awake, and watching travelers float about in zero-G.

A complicated force harness keeps you buckled into your seat.

The Zink magazine is here, smeared flat against your chest.

>wait
Time passes.

>wait
Time passes.

LANDED, BABY!

With a faint beep, your harness buckle goes from red to green.

>look
ORBFLIGHT Cabin
You are seated in a deep leather reclining seat, looking out a fist-sized porthole to the world outside. The ORBFLIGHT cabin is a small, leather and granite-style paneled hemisphere with a handful of similar seats, each one containing a similarly disconnected, quiet traveler. The ceiling of the cabin is a stylized celestial map.
The cabin exits to the outside, east.

The ORBGROUP flight attendant is awake, and watching travelers float about in zero-G.

A complicated force harness keeps you buckled into your seat.

The latest Zink magazine is here.

>look at harness
The harness is a remote-release ORBGROUP-standard five-point acceleration model, designed to keep you safe and secure while the ORBGROUP flight makes initial ascent and final descent.
The harness is secure around your shoulders, keeping you tight to the seat.A green light shines from the harness buckle - you can now open or close the harness yourself.

>open harness
You open the harness.

>look
ORBFLIGHT Cabin
You are seated in a deep leather reclining seat, looking out a fist-sized porthole to the world outside. The ORBFLIGHT cabin is a small, leather and granite-style paneled hemisphere with a handful of similar seats, each one containing a similarly disconnected, quiet traveler. The ceiling of the cabin is a stylized celestial map.
The cabin exits to the outside, east.

The ORBGROUP flight attendant is awake, and watching travelers float about in zero-G.

The seat harness lies discarded, hanging from the seat.

The latest Zink magazine is here.

>e
Alexandria ORBGROUP Terminal

* * *

>SCENES
Scene 'Entire Game' playing (for 57 mins now)
Scene 'Armistice Day' ended 
Scene 'Departure' playing (for 38 mins now)
Scene 'Gunfight' playing (for 5 mins now)
(Scene monitoring now switched on. Type "scenes off" to switch it off again.)

(type SURRENDER to give up)

>SURRENDER
You get down on your knees, putting your hands behind your head.

    *** ENDING #2: TO BE CONTINUED ***

Would you like to RESTART, RESTORE a saved game or QUIT?